# S # # # # # # # # # #
# . # . . # # # . . . #
# . # # . . . # . # . #
# . # . . # . # . # . #
# . . . # . . # . # . #
# # # . # . # . . # . #
# # . . # . . . # . . #
# . . # # # # # # . # #
# # . . . # # # . . # #
# # . # . # . . . # # #
# # # # . # . # # # # # 
# # # # # # F # # # # #
