# # # # # # # # # # # #
# . . . # . . . . . . #
S . # . # . # # # # . #
# # # . # . . . . # . #
# . . . . # # # . # . F
# # # # . # . # . # . #
# . . # . # . # . # . #
# # . # . # . # . # . #
# . . . . . . . . # . #
# # # # # # . # # # . #
# . . . . . . # . . . #
# # # # # # # # # # # #