# S # # # # # # # # # #
# . . . . . # . # # # #
# . # . # . # . # # # #
# # # . # # # . . . . #
# . . . . . . # . # . #
# . # . # # . . . # . #
# . # . . . # # # # . #
# . # # # . . # . . . #
# . . . # # . . # . # #
# # # # # # # . # . . #
# # # # # # # . # # . #
# # # # # # # # # # F #