# S # # # # # # # # # #
# . . . # . . . . . . #
# . # . # . # # # # . #
# # # . # . . . . # . #
# . . . . # # # . # . #
# # # # . # . # . # . #
# . . # . # . # . # . #
# # . # . # . # . # . #
# . . . . . . . . # . #
# # # # # # . # # # . #
# . . . . . . # . . . #
# # # # # # # # F # # #